X=23
Y=23
22222222222222222222222
11111111111111111111111
12222212221212122212221
12121212121212121112111
12121212121212122212221
12111212121212111212111
12111212221222122212221
11111111111111111111111
11111111111111111111111
12221211212221111111111
12M21221212112111111111
12221212212112111111111
12121211212112111111211
12121211212221111111211
11111111111111111111211
11111122212221222221211
11111121112121112111211
11111121112221112111211
11111121112121112111111
11111122212121112111211
11111111111111111111111
11111111111111111111111
22222222222222222222222
RandomWalls=0
NbOfCats=0