X=46
Y=23
2222222222222222222222222222222222222222222222
2000000000000000000000000000000000000000000002
2000011111111111111111000000000000000000000002
2000101000000000000001110000000000000000000002
2000011000000000000000101000000000000000000002
2000101111111111111111100100000000000000000002
2000011111111111111111100010000000000000000002
2000101000002222000000100001000000000000000002
2000011000001111000000102200100000000000000002
2000101000111111000000102200010000000000000002
2000011000111111000000100000001000000000000002
200010100011M111111111100000000100000000000002
2000011000111111111111100000000020000000000002
2000101000111111111111100000000100000000000002
2000011000111111111111111110001000000000000002
2000101000111111111102020011110000000000000002
2000011000111111111100000000100000000000000002
2000101000111111111100000001000000000000000002
2000011000111111111102020010000000000000000002
2000101000011100000111111100000000000000000002
2000011111111000000000000000000000000000000002
2000000000000000000000000000000000000000000002
2222222222222222222222222222222222222222222222
RandomWalls=10
NbOfCats=10